111111111
100000001
1000C0111
1100P0011
1C10000E1
111111111