1111111111111
100C000P00CE1
1111111111111